1111111111111111
1P000000000X11C1
1111111000011001
1000000000011X01
101X101110011CC1
101000C1X0000001
1011111110011X01
10C11E1C10011101
1111X0X01000C101
1CC0000010011101
1XC00X000001C001
1111111111111111