111111
1E00X1
1O0C11
1000P1
111111