1111111111111111111
1P000X0C0X000X00CE1
100X000X000X000X001
1111111111111111111