1111111111111111111
1P000C000X000000CE1
1111111111111111110