111111111111111
1P1111000001001
100011010001C01
1010000X0100001
1000C0000001111
1CCC110100111E1
1C111101X011101
1XC111C000C0001
111111111111111