111111111
1C11000X1
100001001
1P11C10E1
111111111