111111111
1CX1P1CC1
1CC101CC1
101101101
100000001
10C111X01
1001E1001
110X00011
111111111