1111111111111
1CX1P1CC100X1
1CC1C1CC10001
1011E11010001
100000000C001
10C111X010001
1001010010001
110X000110001
1111111111111
