111111111111111
1P1111000001011
100011011101C01
1010000X1100001
1000C0011101111
1CCC110100011E1
1C111101X011101
1X1111C100C0001
111111111111111